61 61 61 61 61 61 61 61 61 61 61 61 61 61 61 61 61 61 61 61 61 61 61 61 61 61 61 61 61 61 61 61 61 61 61 61 61 61 61 61 61 61 61 61 61 61 61 61 61 61 
61 61 61 61 4 4 4 4 4 4 4 4 4 4 4 4 4 4 4 4 4 4 4 4 4 4 4 4 4 4 4 4 4 4 4 4 4 4 61 61 61 61 61 61 61 61 60 61 61 61 
61 61 61 61 4 59 4 4 4 4 4 4 4 4 4 4 4 4 4 4 4 4 4 4 4 4 4 4 4 4 4 4 4 4 4 4 4 4 61 61 61 61 61 61 61 4 4 61 61 61
61 61 61 61 4 4 4 4 4 4 4 4 4 4 4 4 4 4 4 4 4 4 4 4 4 4 4 4 4 4 4 4 4 4 4 4 4 4 4 4 61 61 61 61 61 4 4 61 61 61 
61 61 61 61 61 61 61 61 61 61 61 61 61 61 61 61 61 61 61 61 61 61 61 61 61 61 61 61 61 61 61 61 61 61 61 61 61 61 4 4 61 61 61 61 61 4 4 61 61 61 
61 61 61 61 61 61 61 61 61 61 61 61 61 61 61 61 61 61 61 61 61 61 61 61 61 61 61 61 61 61 61 61 61 61 61 61 61 61 4 4 61 61 4 4 4 4 4 4 4 61 
61 61 61 61 61 61 61 61 61 61 61 61 61 61 61 61 61 61 61 61 61 61 61 61 61 61 61 61 61 61 61 61 61 61 61 61 61 61 4 4 61 61 61 61 4 4 4 4 4 61 
61 61 61 61 61 61 61 61 61 61 61 61 61 61 61 61 61 61 61 61 61 61 61 61 61 61 61 61 61 61 61 61 61 61 61 61 61 61 4 4 61 61 61 61 61 4 4 61 61 61 
61 61 61 61 61 61 61 61 61 61 61 61 61 61 61 61 61 61 61 61 61 61 61 61 61 61 61 61 61 61 61 61 61 61 61 61 61 61 4 4 4 4 4 4 4 4 4 61 61 61 
61 61 61 61 61 61 61 61 61 61 61 61 61 61 61 61 61 61 61 61 4 4 4 61 61 61 61 61 61 61 61 61 61 61 61 61 61 61 4 4 4 4 4 4 4 4 4 61 61 61 
61 61 61 61 61 61 61 61 61 61 61 61 61 61 61 61 61 61 61 61 4 4 4 61 61 61 61 61 61 61 61 61 61 61 61 61 61 61 61 61 61 61 61 61 4 4 4 61 61 61 
61 61 61 61 61 61 61 61 61 61 61 61 61 61 61 61 61 61 61 61 4 4 4 61 61 61 61 61 61 61 61 61 61 61 61 61 61 61 61 61 61 61 61 61 4 4 4 61 61 61 
61 61 61 61 61 61 61 61 61 61 61 61 61 61 61 61 61 61 61 61 4 4 4 61 61 61 61 61 61 61 61 61 61 61 61 61 61 61 61 61 61 61 61 61 4 4 4 61 61 61 
61 61 61 61 61 61 61 61 61 61 61 61 61 61 61 61 61 61 61 61 4 4 4 61 61 61 61 61 61 61 61 61 61 61 61 61 61 61 61 61 61 61 61 61 4 4 4 61 61 61 
61 61 61 61 61 61 61 61 61 61 61 61 61 61 61 61 61 61 61 61 4 4 4 61 61 61 61 61 61 61 61 61 61 61 61 61 61 61 61 61 61 61 61 61 4 4 4 61 61 61 
61 61 61 61 61 61 61 61 61 61 61 61 61 61 61 61 61 61 61 61 4 4 4 61 61 61 61 61 61 61 61 61 61 61 61 61 61 61 61 61 61 61 61 61 4 4 4 61 61 61 
61 61 61 61 61 61 61 61 61 61 61 61 61 61 61 61 61 61 61 61 4 4 4 61 61 61 61 61 61 61 61 61 61 61 61 61 61 61 61 61 61 61 61 61 4 4 4 61 61 61 
61 61 61 61 61 61 61 61 61 61 61 61 61 61 61 61 61 61 61 61 4 4 4 61 61 61 61 61 61 61 61 61 61 61 61 61 61 61 61 61 61 61 61 61 4 4 4 61 61 61 
61 61 61 61 61 61 61 61 61 61 61 61 61 61 61 61 61 61 61 61 4 4 4 61 61 61 61 61 61 61 61 61 61 61 61 61 61 61 61 61 61 61 61 61 4 4 4 61 61 61 
61 61 61 61 61 61 61 61 61 61 61 61 61 61 61 61 61 61 61 61 4 4 4 61 61 61 61 61 61 61 61 61 61 61 61 61 61 61 61 61 61 61 61 61 4 4 4 61 61 61 
61 61 61 61 61 61 61 61 61 61 61 61 61 61 61 61 61 61 61 61 4 4 4 61 61 61 61 61 61 61 61 61 61 61 61 61 61 61 61 61 61 61 61 61 4 4 4 61 61 61 
61 61 61 61 61 61 61 61 61 61 61 61 61 61 61 61 61 61 61 61 4 4 4 61 61 61 61 61 61 61 61 61 61 61 61 61 61 61 61 61 61 61 61 61 4 4 4 61 61 61 
61 61 61 61 61 61 61 61 61 61 61 61 61 61 61 61 61 61 61 61 4 4 4 61 61 61 61 61 61 61 61 61 61 61 61 61 61 61 61 61 61 61 61 61 4 4 4 61 61 61 
61 4 4 4 4 4 4 4 4 4 4 4 4 4 4 4 4 4 4 4 4 4 4 4 4 4 4 4 4 4 4 4 4 4 4 4 4 4 4 4 4 4 4 4 4 4 4 61 61 61 
61 4 4 4 4 4 4 4 4 4 4 4 4 4 4 4 4 4 4 4 4 4 4 4 4 4 4 4 4 4 4 4 4 4 4 4 4 4 4 4 4 4 4 4 4 4 4 61 61 61 
61 4 4 4 4 4 4 4 4 4 4 4 4 4 4 4 4 4 4 4 4 4 4 4 4 4 4 4 4 4 4 4 4 4 4 4 4 4 4 4 4 4 4 4 4 4 4 61 61 61 
61 61 61 61 61 61 61 61 61 61 61 61 61 61 61 61 61 61 61 61 4 4 4 61 61 61 61 61 61 61 61 61 61 61 61 61 61 61 61 61 61 61 61 61 4 4 4 61 61 61 
61 61 61 61 61 61 61 61 61 61 61 61 61 61 61 61 61 61 61 61 4 4 4 61 61 61 61 61 61 61 61 61 61 61 61 61 61 61 61 61 61 61 61 61 4 4 4 61 61 61 
61 61 61 61 61 61 61 61 61 61 61 61 61 61 61 61 61 61 61 61 4 4 4 61 61 61 61 61 61 61 61 61 61 61 61 61 61 61 61 61 61 61 61 61 4 4 4 61 61 61 
61 61 61 61 61 61 61 61 61 61 61 61 61 61 61 61 61 61 61 61 4 4 4 61 61 61 61 61 61 61 61 61 61 61 61 61 61 61 61 61 61 61 61 61 4 4 4 61 61 61 
61 61 61 61 61 61 61 61 61 61 61 61 61 61 61 61 61 61 61 61 4 4 4 61 61 61 61 61 61 61 61 61 61 61 61 61 61 61 61 61 61 61 61 61 4 4 4 61 61 61 
61 61 61 61 61 61 61 61 61 61 61 61 61 61 61 61 61 61 61 61 4 4 4 61 61 61 61 61 61 61 61 61 61 61 61 61 61 61 61 61 61 61 61 61 4 4 4 61 61 61 
61 61 61 61 61 61 61 61 61 61 61 61 61 61 61 61 61 61 61 61 4 4 4 61 61 61 61 61 61 61 61 61 61 61 61 61 61 61 61 61 61 61 61 61 4 4 4 61 61 61 
61 61 61 61 61 61 61 61 61 61 61 61 61 61 61 61 61 61 61 61 4 4 4 61 61 61 61 61 61 61 61 61 61 61 61 61 61 61 61 61 61 61 61 61 4 4 4 61 61 61 
61 4 4 4 4 4 4 4 4 4 4 4 4 4 4 4 4 4 4 4 61 61 61 61 61 61 61 61 61 61 61 61 61 61 61 61 61 61 61 61 61 61 61 61 4 4 4 61 61 61 
61 4 4 4 4 4 4 4 4 4 4 4 4 4 4 4 4 4 4 4 61 61 61 61 61 61 61 61 61 61 61 61 61 61 61 61 61 61 61 61 61 61 61 61 4 4 4 61 61 61 
61 4 4 4 4 4 4 4 4 4 4 4 4 4 4 4 4 4 4 4 61 61 61 61 61 61 61 61 61 61 61 61 61 61 61 61 61 61 61 61 61 61 61 61 4 4 4 61 61 61 
61 4 4 4 4 4 4 4 4 4 4 4 4 4 4 4 4 4 4 4 61 61 61 61 61 61 61 61 61 61 61 61 61 61 61 61 61 61 61 61 61 61 61 61 4 4 4 61 61 61 
61 4 4 4 4 4 4 4 4 4 4 4 4 4 4 4 4 4 4 4 61 61 61 61 61 61 61 61 61 61 61 61 61 61 61 61 61 61 61 61 61 61 61 61 4 4 4 61 61 61 
61 4 4 4 4 4 4 4 4 4 4 4 4 4 4 4 4 4 4 4 4 4 4 4 4 4 4 4 4 4 4 4 4 4 4 4 4 4 4 4 4 4 4 4 4 4 4 61 61 61 
61 4 4 4 4 4 4 4 4 4 4 4 4 4 4 4 4 4 4 4 4 4 4 4 4 4 4 4 4 4 4 4 4 4 4 4 4 4 4 4 4 4 4 4 4 4 4 61 61 61 
61 4 4 4 4 4 4 4 4 4 4 4 4 4 4 4 4 4 4 4 4 4 4 4 4 4 4 4 4 4 4 4 4 4 4 4 4 4 4 4 4 4 4 4 4 4 4 61 61 61 
61 4 4 4 4 4 4 4 4 4 4 4 4 4 4 4 4 4 4 4 61 61 61 61 61 61 61 61 61 61 61 61 61 61 61 61 61 61 61 61 61 61 61 61 61 61 61 61 61 61 
61 4 4 4 4 4 4 4 4 4 4 4 4 4 4 4 4 4 4 4 61 61 61 61 61 61 61 61 61 61 61 61 61 61 61 61 61 61 61 61 61 61 61 61 61 61 61 61 61 61 
61 4 4 4 4 4 4 4 4 4 4 4 4 4 4 4 4 4 4 4 61 61 61 61 61 61 61 61 61 61 61 61 61 61 61 61 61 61 61 61 61 61 61 61 61 61 61 61 61 61 
61 4 4 4 4 4 4 4 4 4 4 4 4 4 4 4 4 4 4 4 61 61 61 61 61 61 61 61 61 61 61 61 61 61 61 61 61 61 61 61 61 61 61 61 61 61 61 61 61 61 
61 4 4 4 4 4 4 4 4 4 4 4 4 4 4 4 4 4 4 4 61 61 61 61 61 61 61 61 61 61 61 61 61 61 61 61 61 61 61 61 61 61 61 61 61 61 61 61 61 61 
61 4 4 4 4 4 4 4 4 4 4 4 4 4 4 4 4 4 4 4 61 61 61 61 61 61 61 61 61 61 61 61 61 61 61 61 61 61 61 61 61 61 61 61 61 61 61 61 61 61 
61 4 59 4 4 4 4 4 4 4 4 4 4 4 4 4 4 4 4 4 61 61 61 61 61 61 61 61 61 61 61 61 61 61 61 61 61 61 61 61 61 61 61 61 61 61 61 61 61 61 
61 61 61 61 61 61 61 61 61 61 61 61 61 61 61 61 61 61 61 61 61 61 61 61 61 61 61 61 61 61 61 61 61 61 61 61 61 61 61 61 61 61 61 61 61 61 61 61 61 61 
