9 9 9 9 9 9 9 9 9 9 9 9 9 9 9 9 9 9 9 9 9 9 9 9 9 9 9 9 9 9 9 9 9 9 9 9 9 9 9 9 9 9 9 9 9 9 9 9 9 9 
9 9 9 9 9 9 9 9 9 9 9 9 9 9 9 9 9 9 9 9 9 9 9 9 9 9 9 9 9 9 9 9 9 9 9 9 9 9 9 9 9 9 9 9 9 9 9 9 9 9 
9 9 9 9 9 9 9 9 9 9 9 9 9 9 9 9 9 9 9 9 9 9 9 9 9 9 9 9 9 9 9 9 9 9 9 9 9 9 9 9 9 9 9 9 9 9 9 9 9 9 
9 9 9 9 9 9 9 9 9 9 9 9 9 9 9 9 9 9 9 9 9 9 9 9 9 9 9 9 9 9 9 9 9 9 9 9 9 9 9 9 9 9 9 9 9 9 9 9 9 9 
9 9 9 9 9 9 9 9 9 9 9 9 9 9 9 9 9 9 9 9 9 9 9 9 9 9 9 9 9 9 9 9 9 9 9 9 9 9 9 9 9 9 9 9 9 9 9 9 9 9 
9 9 9 9 9 23 21 21 21 21 21 21 21 21 21 21 21 21 21 21 21 21 21 21 21 21 21 21 21 21 21 21 21 21 21 21 21 21 21 21 21 21 21 21 24 9 9 9 9 9 
9 9 9 9 9 20 2 2 13 13 13 13 2 2 2 2 14 14 14 14 14 2 2 2 2 2 2 13 13 13 14 14 14 14 14 14 14 14 14 14 14 14 13 58 19 9 9 9 9 9
9 9 9 9 9 20 2 2 13 13 13 13 2 2 2 2 14 14 14 14 14 2 2 2 2 2 2 13 13 13 14 14 14 14 14 14 14 14 14 14 14 14 13 13 19 9 9 9 9 9 
9 9 9 9 9 20 2 2 13 13 13 13 2 2 2 2 14 14 14 14 14 2 2 2 2 2 2 13 13 13 13 13 13 13 13 13 13 13 13 13 14 14 13 13 19 9 9 9 9 9 
9 9 9 9 9 20 2 2 13 13 13 13 2 2 2 2 14 14 14 14 14 2 2 2 2 2 2 13 13 13 2 2 2 2 2 2 2 2 2 13 14 14 13 13 19 9 9 9 9 9 
9 9 9 9 9 20 2 2 13 13 13 13 2 2 2 2 14 14 14 14 14 14 2 2 2 2 2 13 13 13 2 2 2 2 2 2 2 2 2 13 14 14 13 13 19 9 9 9 9 9 
9 9 9 9 9 20 14 14 2 13 13 14 14 2 2 2 2 2 14 14 14 14 2 2 2 2 2 13 13 13 2 2 2 2 2 2 2 2 2 13 14 14 13 13 19 9 9 9 9 9 
9 9 9 9 9 20 14 14 2 13 13 14 14 2 2 2 2 2 14 14 14 14 2 2 2 2 2 13 13 13 2 2 2 2 2 2 2 2 2 13 14 14 13 13 19 9 9 9 9 9 
9 9 9 9 9 20 14 14 2 13 13 14 14 2 2 2 2 2 14 14 14 14 2 2 2 2 2 13 13 13 2 2 2 2 2 2 14 14 14 13 14 14 13 13 19 9 9 9 9 9 
9 9 9 9 9 20 14 14 2 13 13 14 14 2 2 2 2 2 14 14 14 14 2 2 2 2 2 13 13 13 2 2 2 2 2 2 14 14 14 13 14 14 13 13 19 9 9 9 9 9
9 9 9 9 9 20 14 14 14 13 13 13 13 13 13 13 13 13 13 13 13 13 13 13 13 13 13 13 13 13 2 2 2 2 2 2 14 14 14 13 14 14 13 13 19 9 9 9 9 9 
9 9 9 9 9 20 14 14 14 2 2 2 2 2 2 2 2 13 14 14 14 14 2 2 2 2 2 13 13 13 2 2 2 2 2 2 14 14 13 13 14 14 13 13 19 9 9 9 9 9 
9 9 9 9 9 20 14 14 2 2 2 2 2 2 2 2 2 13 14 14 14 14 2 2 2 2 2 13 13 13 2 2 2 2 2 2 14 14 13 14 14 14 13 13 19 9 9 9 9 9 
9 9 9 9 9 20 14 14 2 14 14 14 14 14 14 14 14 13 14 14 14 14 2 2 2 2 2 13 13 13 2 2 2 2 2 2 14 14 13 14 14 14 13 13 19 9 9 9 9 9
9 9 9 9 9 20 14 14 14 14 14 14 14 14 14 14 14 13 14 14 14 14 2 2 2 2 2 13 13 13 14 14 14 14 14 14 13 13 13 14 14 14 13 13 19 9 9 9 9 9 
9 9 9 9 9 20 14 14 14 2 2 2 2 2 2 2 2 13 14 14 14 14 2 2 2 2 2 13 13 13 13 13 13 13 13 13 13 2 2 2 2 2 13 13 19 9 9 9 9 9
9 9 9 9 9 20 14 14 14 2 2 2 2 2 2 2 2 13 2 2 2 2 2 14 14 14 14 13 13 13 14 14 14 14 14 14 2 2 2 2 2 2 13 13 19 9 9 9 9 9 
9 9 9 9 9 20 2 2 2 2 2 2 2 2 2 2 2 13 14 14 14 14 14 14 14 14 14 13 13 13 14 14 14 14 14 14 14 2 2 2 2 2 13 13 19 9 9 9 9 9 
9 9 9 9 9 20 2 2 2 2 2 2 2 2 2 2 2 13 14 14 14 14 14 14 14 14 14 13 13 13 14 14 14 14 14 14 14 2 2 2 2 2 13 13 19 9 9 9 9 9 
9 9 9 9 9 20 2 2 2 2 2 2 2 2 2 2 2 13 14 14 14 14 14 14 14 14 14 13 13 13 14 14 14 14 14 14 14 2 2 2 2 2 13 13 19 9 9 9 9 9 
9 9 9 9 9 20 2 2 2 2 2 2 2 2 2 2 2 13 14 14 14 14 14 14 14 14 14 13 13 13 14 14 14 2 2 2 2 2 2 2 2 64 13 13 19 9 9 9 9 9
9 9 9 9 9 17 3 3 3 3 3 3 3 3 3 3 3 3 3 3 3 3 3 3 3 3 3 3 3 3 3 3 3 3 3 3 3 3 3 3 3 3 3 3 18 9 9 9 9 9 
9 9 9 9 9 17 3 3 3 3 3 3 3 3 3 3 3 3 3 3 3 3 3 3 3 3 3 3 3 3 3 3 3 3 3 3 3 3 3 3 3 3 3 3 18 9 9 9 9 9 
9 9 9 9 9 17 3 3 3 3 3 3 3 3 3 3 3 3 3 3 3 3 3 3 3 3 3 3 3 3 3 3 3 3 3 3 3 3 3 3 3 3 3 3 18 9 9 9 9 9 
9 9 9 9 9 20 2 2 2 2 2 2 2 2 2 2 2 14 14 13 13 14 14 14 14 2 2 13 13 13 2 2 2 2 2 2 2 2 2 2 2 2 2 13 19 9 9 9 9 9 
9 9 9 9 9 20 2 2 2 2 2 2 2 2 2 2 2 14 14 13 13 14 14 14 14 2 2 13 13 13 2 2 2 2 2 2 2 2 2 2 2 2 13 13 19 9 9 9 9 9 
9 9 9 9 9 20 2 2 2 2 2 2 2 2 2 2 2 14 14 13 13 14 14 14 14 2 2 13 13 13 2 2 2 2 2 2 13 13 13 13 13 13 13 2 19 9 9 9 9 9 
9 9 9 9 9 20 2 2 2 2 2 2 2 2 2 2 2 2 2 13 13 14 14 14 14 2 2 13 13 13 2 2 2 2 13 13 13 13 13 14 14 14 14 2 19 9 9 9 9 9 
9 9 9 9 9 20 2 2 2 14 14 14 14 14 14 14 14 14 14 13 13 14 14 14 14 2 2 13 13 13 2 2 2 2 13 14 14 14 14 14 14 14 14 2 19 9 9 9 9 9 
9 9 9 9 9 20 2 2 2 14 14 14 14 14 14 14 14 14 14 13 13 14 14 14 14 2 2 13 13 13 2 2 2 2 13 14 14 14 14 14 14 14 14 2 19 9 9 9 9 9 
9 9 9 9 9 20 2 2 2 14 14 14 14 14 14 14 14 14 14 13 13 14 14 14 14 2 2 13 13 13 2 2 2 2 13 14 14 14 14 14 14 14 14 14 19 9 9 9 9 9 
9 9 9 9 9 20 2 2 2 14 14 14 14 14 14 14 13 13 13 13 13 14 14 14 14 2 2 13 13 13 14 14 14 14 13 14 14 14 14 14 14 14 14 14 19 9 9 9 9 9 
9 9 9 9 9 20 2 2 13 13 13 13 13 13 13 13 13 13 13 13 13 14 14 14 14 2 2 13 13 13 14 14 14 14 13 14 14 14 14 14 14 14 14 14 19 9 9 9 9 9 
9 9 9 9 9 20 2 2 13 13 13 13 13 13 13 13 13 13 13 13 13 14 14 14 14 2 2 13 13 13 14 14 14 14 13 13 14 14 14 14 14 14 14 14 19 9 9 9 9 9
9 9 9 9 9 20 2 2 13 14 14 14 14 14 14 14 14 14 14 14 14 14 14 14 2 2 2 13 13 13 14 14 14 14 14 13 13 13 13 13 13 13 14 14 19 9 9 9 9 9 
9 9 9 9 9 20 14 14 13 14 14 14 14 14 14 14 14 14 14 14 14 14 14 14 2 2 2 13 13 13 14 14 14 14 14 14 14 14 14 14 14 13 13 13 19 9 9 9 9 9 
9 9 9 9 9 20 14 14 13 14 14 14 14 14 14 14 14 14 14 14 14 14 14 14 2 2 2 13 13 13 14 14 13 13 13 13 14 14 14 14 14 2 2 13 19 9 9 9 9 9 
9 9 9 9 9 20 13 13 13 2 2 2 2 2 2 14 14 14 14 14 14 14 14 14 2 2 2 13 13 13 14 14 13 13 13 13 2 2 2 2 2 2 13 13 19 9 9 9 9 9
9 9 9 9 9 20 13 13 13 2 2 2 2 2 2 14 14 14 14 14 14 14 14 14 2 2 2 13 13 13 14 14 13 13 13 13 13 13 13 13 13 13 13 2 19 9 9 9 9 9 
9 9 9 9 9 26 22 22 22 22 22 22 22 22 22 22 22 22 22 22 22 22 22 22 22 22 22 22 22 22 22 22 22 22 22 22 22 22 22 22 22 22 22 22 25 9 9 9 9 9 
9 9 9 9 9 9 9 9 9 9 9 9 9 9 9 9 9 9 9 9 9 9 9 9 9 9 9 9 9 9 9 9 9 9 9 9 9 9 9 9 9 9 9 9 9 9 9 9 9 9 
9 9 9 9 9 9 9 9 9 9 9 9 9 9 9 9 9 9 9 9 9 9 9 9 9 9 9 9 9 9 9 9 9 9 9 9 9 9 9 9 9 9 9 9 9 9 9 9 9 9 
9 9 9 9 9 9 9 9 9 9 9 9 9 9 9 9 9 9 9 9 9 9 9 9 9 9 9 9 9 9 9 9 9 9 9 9 9 9 9 9 9 9 9 9 9 9 9 9 9 9 
9 9 9 9 9 9 9 9 9 9 9 9 9 9 9 9 9 9 9 9 9 9 9 9 9 9 9 9 9 9 9 9 9 9 9 9 9 9 9 9 9 9 9 9 9 9 9 9 9 9 
9 9 9 9 9 9 9 9 9 9 9 9 9 9 9 9 9 9 9 9 9 9 9 9 9 9 9 9 9 9 9 9 9 9 9 9 9 9 9 9 9 9 9 9 9 9 9 9 9 9 
